200000000100010000000
110101111101010111010
000040000001000100000
010111111111111101111
010104000001000101000
010101111101011101010
000100000001000100000
110111011111110101010
000100000000000001000
011101010111010101110
000000500100000100000
111101111101110101110
000000600000000101000
011101011111011111010
000001000100000101000
010111110101110101111
010000000001000100000
011101010111010111110
000100010001010000010
110111110111110111010
000000000000000000003